0030302201
0000000000
0000000002
3000230002
2000320003
2000000000
0000000000
1022030300